........
.#######
.#.....#
.###...#
...#...#
...#...#
.###.###
.#...#..
.##..###
..#....#
..######
